"a" = (/turf/space,/area/space)
"b" = (/turf/simulated/wall,/area/space)
"c" = (/turf/simulated/floor/tiled,/area/space)
"d" = (/obj/machinery/light{dir = 1},/turf/simulated/floor/tiled,/area/space)
"e" = (/obj/effect/landmark{name = "tdome1"},/turf/simulated/floor/tiled,/area/space)
"f" = (/obj/effect/floor_decal/industrial/hatch/yellow,/turf/simulated/floor/tiled,/area/space)
"g" = (/obj/machinery/light_switch{pixel_x = 25},/turf/simulated/floor/tiled,/area/space)
"h" = (/obj/machinery/light{icon_state = "tube1"; dir = 8},/turf/simulated/floor/tiled,/area/space)
"i" = (/obj/structure/ladder/up,/turf/simulated/floor/tiled,/area/space)
"j" = (/obj/machinery/light{icon_state = "tube1"; dir = 4},/turf/simulated/floor/tiled,/area/space)
"k" = (/obj/machinery/atmospherics/unary/vent_pump/on,/turf/simulated/floor/tiled,/area/space)
"l" = (/obj/machinery/atmospherics/pipe/simple/visible{tag = "icon-intact (NORTHEAST)"; icon_state = "intact"; dir = 5},/turf/simulated/floor/tiled,/area/space)
"m" = (/obj/machinery/atmospherics/pipe/simple/visible{tag = "icon-intact (EAST)"; icon_state = "intact"; dir = 4},/turf/simulated/floor/tiled,/area/space)
"n" = (/obj/machinery/atmospherics/portables_connector{tag = "icon-map_connector (WEST)"; icon_state = "map_connector"; dir = 8},/obj/machinery/portable_atmospherics/canister/air,/turf/simulated/floor/tiled,/area/space)
"o" = (/obj/effect/landmark/start,/turf/simulated/floor/tiled,/area/space)
"p" = (/obj/machinery/atmospherics/pipe/simple/visible{tag = "icon-intact (SOUTHEAST)"; icon_state = "intact"; dir = 6},/turf/simulated/floor/tiled,/area/space)
"q" = (/obj/machinery/atmospherics/portables_connector{tag = "icon-map_connector (WEST)"; icon_state = "map_connector"; dir = 8},/obj/machinery/portable_atmospherics/canister/empty,/turf/simulated/floor/tiled,/area/space)
"r" = (/obj/machinery/light_switch{pixel_x = -25},/turf/simulated/floor/tiled,/area/space)
"s" = (/obj/machinery/atmospherics/unary/vent_scrubber/on{tag = "icon-map_scrubber_on (NORTH)"; icon_state = "map_scrubber_on"; dir = 1},/turf/simulated/floor/tiled,/area/space)
"t" = (/obj/effect/landmark{name = "JoinLate"},/turf/simulated/floor/tiled,/area/space)
"u" = (/obj/structure/cable{d2 = 2; icon_state = "0-2"; pixel_y = 0},/obj/machinery/power/apc{dir = 8; name = "west bump"; pixel_x = -24},/turf/simulated/floor/tiled,/area/space)
"v" = (/obj/effect/landmark/test/safe_turf,/turf/simulated/floor/tiled,/area/space)
"w" = (/obj/structure/cable{d1 = 1; d2 = 2; icon_state = "1-2"; pixel_y = 0},/turf/simulated/floor/tiled,/area/space)
"x" = (/obj/structure/cable,/obj/machinery/power/debug_items/infinite_generator,/turf/simulated/floor/tiled,/area/space)
"y" = (/obj/machinery/light,/turf/simulated/floor/tiled,/area/space)
"z" = (/obj/effect/landmark/test/space_turf,/turf/space,/area/space)

(1,1,1) = {"
aaaaaaaaaaaaaaaaaaaaaaaaaaaaaaaa
aaaaaaaaaaaaaaaaaaaaaaaaaaaaaaaa
aaaaaaaaaaaaaaaaaaaaaaaaaaaaaaaa
aaaaaaaaaaaaaaaaaaaaaaaaaaaaaaaa
aaaaaaaaaaaaaaaaaaaaaaaaaaaaaaaa
aaaaaaaaaaaaaaaaaaaaaaaaaaaaaaaa
aaaaaaaaaaaaaaaaaaaaaaaaaaaaaaaa
aaaaaaaaaaaaaaaaaaaaaaaaaaaaaaaa
aaaaaaaaaaaaaaaaaaaaaaaaaaaaaaaa
aaaaaaaaabbbbbbbbbbbbbbbaaaaaaaa
aaaaaaaaabcccdcccccdcccbaaaaaaaa
aaaaaaaaabceeecfbfcccccbaaaaaaaa
aaaaaaaaabceeecfffccccgbaaaaaaaa
aaaaaaaaabheeeifffccccjbaaaaaaaa
aaaaaaaaabcccccccccckccbaaaaaaaa
aaaaaaaaabcccccccccclmnbaaaaaaaa
aaaaaaaaabccccccoccccccbaaaaaaaa
aaaaaaaaabccccccccccpmqbaaaaaaaa
aaaaaaaaabrcccccccccsccbaaaaaaaa
aaaaaaaaabhctttcccccccjbaaaaaaaa
aaaaaaaaabuctttcccvccccbaaaaaaaa
aaaaaaaaabwctttccccccccbaaaaaaaa
aaaaaaaaabxccycccccycccbaaaaaaaa
aaaaaaaaabbbbbbbbbbbbbbbaaaaaaaa
aaaaaaaazaaaaaaaaaaaaaaaaaaaaaaa
aaaaaaaaaaaaaaaaaaaaaaaaaaaaaaaa
aaaaaaaaaaaaaaaaaaaaaaaaaaaaaaaa
aaaaaaaaaaaaaaaaaaaaaaaaaaaaaaaa
aaaaaaaaaaaaaaaaaaaaaaaaaaaaaaaa
aaaaaaaaaaaaaaaaaaaaaaaaaaaaaaaa
aaaaaaaaaaaaaaaaaaaaaaaaaaaaaaaa
aaaaaaaaaaaaaaaaaaaaaaaaaaaaaaaa
"}
